WIDTH=17
HEIGHT=17
1,1,1,1,1,1,1,1,1,1,1,1,1,1,1,1,1
1,0,0,0,1,2,0,2,1,2,0,2,1,0,0,0,1
1,0,0,0,2,6,1,5,2,6,1,5,2,0,0,0,1
1,0,0,0,1,2,0,2,1,2,0,2,1,0,0,0,1
1,2,1,1,1,0,7,0,2,0,7,0,1,1,1,2,1
1,0,2,0,5,2,1,6,5,6,1,2,5,0,2,0,1
1,2,1,2,1,5,2,0,2,0,2,5,1,2,1,2,1
1,7,2,0,0,7,1,2,0,2,1,7,0,0,2,7,1
1,1,0,5,1,2,0,0,5,0,0,2,1,5,0,1,1
1,7,2,0,0,7,1,2,0,2,1,7,0,0,2,7,1
1,2,1,2,1,5,2,0,2,0,2,5,1,2,1,2,1
1,0,2,0,5,2,1,6,5,6,1,2,5,0,2,0,1
1,2,1,1,1,0,7,0,2,0,7,0,1,1,1,2,1
1,0,0,0,1,2,0,2,1,2,0,2,1,0,0,0,1
1,0,0,0,2,6,1,5,2,6,1,5,2,0,0,0,1
1,0,0,0,1,2,0,2,1,2,0,2,1,0,0,0,1
1,1,1,1,1,1,1,1,1,1,1,1,1,1,1,1,1